github.com/unused-interface-methods/unused-interface-methods/internal/analizer/analizer.go:35:	collectInterfaceMethods	78.8%
github.com/unused-interface-methods/unused-interface-methods/internal/analizer/analizer.go:101:	newMethodAnalyzer	100.0%
github.com/unused-interface-methods/unused-interface-methods/internal/analizer/analizer.go:110:	analyzeUsedMethods	100.0%
github.com/unused-interface-methods/unused-interface-methods/internal/analizer/analizer.go:116:	analyze			100.0%
github.com/unused-interface-methods/unused-interface-methods/internal/analizer/analizer.go:137:	analyzeSelectorExpr	100.0%
github.com/unused-interface-methods/unused-interface-methods/internal/analizer/analizer.go:150:	markMatchingMethods	100.0%
github.com/unused-interface-methods/unused-interface-methods/internal/analizer/analizer.go:163:	isMethodMatch		100.0%
github.com/unused-interface-methods/unused-interface-methods/internal/analizer/analizer.go:179:	checkImplements		100.0%
github.com/unused-interface-methods/unused-interface-methods/internal/analizer/analizer.go:197:	checkGenericImplements	87.5%
github.com/unused-interface-methods/unused-interface-methods/internal/analizer/analizer.go:213:	analyzeCallExpr		100.0%
github.com/unused-interface-methods/unused-interface-methods/internal/analizer/analizer.go:227:	extractFunctionIdent	100.0%
github.com/unused-interface-methods/unused-interface-methods/internal/analizer/analizer.go:239:	isFmtFunction		100.0%
github.com/unused-interface-methods/unused-interface-methods/internal/analizer/analizer.go:245:	analyzeFmtCall		80.0%
github.com/unused-interface-methods/unused-interface-methods/internal/analizer/analizer.go:257:	checkStringerUsage	100.0%
github.com/unused-interface-methods/unused-interface-methods/internal/analizer/analizer.go:270:	isStringerMethod	100.0%
github.com/unused-interface-methods/unused-interface-methods/internal/analizer/analizer.go:285:	reportUnusedMethods	100.0%
github.com/unused-interface-methods/unused-interface-methods/internal/analizer/analizer.go:315:	run			100.0%
github.com/unused-interface-methods/unused-interface-methods/internal/analizer/analizer.go:322:	Run			0.0%
github.com/unused-interface-methods/unused-interface-methods/internal/analizer/init.go:17:	init			55.6%
github.com/unused-interface-methods/unused-interface-methods/internal/analizer/init.go:31:	extractBasePath		100.0%
github.com/unused-interface-methods/unused-interface-methods/internal/config/config.go:18:	defaultConfig		100.0%
github.com/unused-interface-methods/unused-interface-methods/internal/config/config.go:31:	findConfigFile		100.0%
github.com/unused-interface-methods/unused-interface-methods/internal/config/config.go:51:	matchPattern		100.0%
github.com/unused-interface-methods/unused-interface-methods/internal/config/config.go:61:	ShouldIgnore		100.0%
github.com/unused-interface-methods/unused-interface-methods/internal/config/config.go:75:	LoadConfig		87.5%
github.com/unused-interface-methods/unused-interface-methods/main.go:7:				main			0.0%
total:												(statements)		89.9%
